10
XXXXXXXXXX
XOOXOOOXOX
XOOXOOOXOX
XOOOOXXOOX
XOXXXOOOOX
XOOOXOOOOX
XOXOOOXOOX
XOXXXOXXOX
XXOOOOOOOX
XXXXXXXXXX
2
2
9
9
